#######
#E..G.#
#..E..#
#G..E.#
#######